8 8
# # # # # # # #
# . . . . . . #
# # . . # . . #
# . . # # . . #
# . . . # . # #
# . . E # S . #
# . . . . . . #
# # # # # # # #