12 11
# # # # # # # # # # #
# # . . . . # # . # #
# # . # # . # # . # #
# # . . # E . . . # #
# # . # # # # # . . #
# # . # . . . . . # #
# # . # . # . # # # #
# . . . . # # # . . #
# # . # . # . . . # #
# # . # . # . # # # #
# # . # . . . . . S #
# # # # # # # # # # #
